laud - to praise highly

parody - humorous imitation for comic effect esp. in art and literature

martial - associated with war and the armed forces

perennial - recurrent through the years or many years

perspicacious - acutely perceptive, having keen discernment 

mundane - of the world; typical of or concerned with the ordinary

prattle - to babble meaninglessly; to talk in an empty and idle manner

predilection - a disposition in favor of something; preference

filibuster - intentional obstruction esp. using prolonged speech making to delay legislative action

noxious - harmful, injurious 

synthesis - the combinatino of parts to make a whole

truculent - fierce and cruel; eager to fight 

veracity - truthfulness, honesty

voracious - having an insatiable appetite for an activity or pursuit; ravenous

waver - to move to and fro; to sway; to be unsettled in opinion 

abscond - to depart clandestinely; to steal off and hide

stymie - to block; thwart

stupefy - to stun, baffle, or amaze

static - not moving, active, or in motion; at rest

squander - to waste by spending or unsing irresponsibly

sporadic - occuring only occasionally, or in scattered instances

sordid - characterized by filth, grime, or squalor; foul

reticent - quiet; reserved; reluctant to express thoughts or feelings

relegate - to forcibly assign, esp to a lower place or position

alacrity - eager and enthusiastic willingness

aberrant - deviating from the norm

audacious - daring and fearless; recklessly bold

austere - without adornment; bare; severely simple; ascetic

axiomatic - taken as given; possessing self evident truth

canonical - following or in agreement with accepted, traditional standards

capricious - inclined to change one's mind impulsively; erratic, unpredictable

connoisseur - an informed and astute judge in matters of taste; expert

convoluted - complex or complicated

discordant - conflicting; dissonant or harsh in sound

disparate - fundamentally distinct or different; dissimiliar

extemporaneous - improvised; done without preparation

exigent - urgent, pressing, requiring immediate action or attention

erudite - very learned, scholarly

equivocate - to use ambiguous language with a deceptive intent

assuage - to ease or lessen; to appease or pacify

torque - a force that causes rotation

magnanimity - quality of being generously noble in mind and  heart, esp in forgiving 

solicitous - concerned and attentive, eager

chicanery - trickery and subterfuge

censure - to criticize severely; to officially rebuke

nascent - come into being; in early developmental stages

precipitate (adj)  - acting with excessive haste or impulse

precipitate (v) - to cause to happen before anticipated or required

approbation - an expression of approval or praise 

arduous - strenuous, taxing; requiring significant effort

anomaly - deviation from the normal order, form, or rule; abnormality

exculpate - exonerate, clear or blame

ingenuous - artless; frank; candid; lacking in sophistication

inured - accustomed to accepting something undesirable

irascible - easily angered; prone to tempermental outbursts

obviate - to anticipate and prevent or eliminate by effective measures

refute - to disprove; to successfully argue against

disabuse - to undecieve; to set right

perfidy - intentional breach of faith, treachery

onerous - troubling; burdensome

perfunctory - cursory; done without care or interest

fulminate - to loudly attack or denounce

qualms - misgivings; reservations; causes for hesistancy

lucid - clear; easily understood

prescience - foreknowledge of events

recant - to retract, esp. previously held beliefs

prevaricate - to deliberately avoid the truth; to mislead

effrontery - extreme boldness; presumptuousness

tortuous - winding, twisting; excessively complicated

virulent - extremely harmful or poisonous; bittery hostile or antagonistic

ennui - dissatisfaction and restlessness resulting from boredom or apathy

eloquent - well spoken, expressive and articulate

enervate - to weaken; to reduce in vitality

neologism - a new word, expression or usage; the creation or use of new words or senses

obtuse - lacking sharpness of intellect; not clear or precise in thoughts in expression 

paean - a song of praise and thanksgiving
