acumen - keen, accurate judgment or insight

adulterate - to reduce purity by combining with inferior ingredients

amalgamate - to combine several elements into a whole 

archaic - outdated; associated with an earlier, perhaps more primitive time

aver - to state as a fact; to declare or assert

bolster - to provide support or reinforcement

bombastic - pompous; grandiloquent

diabtribe - a harsh denunciation

eccentric - departing from norms or conventions

endemic - characteristic of or often found in a particular locality, region, or people

evanescent - tending to disappear like vapor; vanishing

exacerbate - to make worse or more severe

fervent - greatly emotional or zealous

fortuitous - happening by chance or accident

germane - relevant to the subject at hand; appropriate in subject matter

grandiloquence - pompous speech or expression

hackneyed - rendered trite or commonplace by frequent usage

halcyon - calm and peaceful; rich and prosperous; a mythical bird

hedonism - devotion to pleasurable pursuits esp. ones of the senses

hegemony - the consistent dominance of one state or ideology over others

iconoclast - one who attacks or undermines traditional conventions or institutions

idolatrous - given to intense devotion or excessive devotion to something

imperturbable - marked by extreme calm, impassivity and steadiness

impassive - revealing no emotion

implacable - not capable of being appeased or significantly changed

placate - to appease; to calm by making concessions

impunity - immunity from punishment or penalty

inchoate - in an initial stage; not fully formed

infelicitous - unfortunate; inappropriate

insipid - without taste or flavor; lacking in spirit; bland

loquacious - extremely talkative 

luminous - characterized by brightness and the emission of light

malevolent - having or showing often vicious ill will, spite, or hatred

malleable - capable of being shaped or formed; tractable; pliable

mendacity - the condition of being untruthful; dishonesty

meticulous - characterized by extreme care and precision; attentive to detail

misanthrope - one who hates all other humans

mitigate - to make less severe or intense; to moderate

specious - seeming true, but actually being fallacious; misleadingly attractive; plausible but false

zealous - fervent; ardent; impassioned, devoted to a cause

transient - fleeting; passing quickly; brief

tirade - a long and extremely critical speech; diatribe

tenuous - having little substance or strength; flimsyl weak

tenacity - the quality of adherence or persistence to something valued; determination

surfeit - an overabundant supply; excess; to feed or supply to excess

superfluous - exceeding what is needed or necessary

succinct - brief; concise

subpoena - a court order requiring appearance and or testimony 

spurious - lacking authenticity or validity; false; counterfeit

dissemble - to disguise or conceal; to mislead

solvent - able to meet financial obligations; able to dissolve another substance

salubrious - promoting health or well being

rhetoric - the art of effective use of language for communicaiton and persuasion

reverent - marked by, feeling, or exressing feeling of profound awe and respect

rescind - to invalidate; to repeal; to retract

rancorous - characterized by bitter, long lasting resentment

querulous - prone to complaining or grumbling; peevish

queries - questions; inquiries; doubts in the mind; reservations

proliferate - to grow or increase swiftly and abundantly 

plummet - to plunge or drop straight down

pithy - precise and brief 

pith - the essential or central part

pirate - to illegally use or produce

pine - to yearn intensely; to languish; to lose vigor 

pervasive - having the tendency to permeate or spread throughout

penury - poverty; destitution

pedantic - show offish about one's knowledge

pedagogy - the profession or principles of teaching or instructing

opprobrium - disgrace; contempt; scorn

occlude - to obstruct or block

obsequious - exhibiting a fawning attentiveness

obdurate - unyielding hard hearted; intractable 

platitude - a superficial remark, esp one offered as meaningful

polemical - controversial; argumentative

prodigal - recklessly wasteful; extravagant; profuse; lavish

profuse - given or coming forth abundantly; extravagant

recalcitrant - obstinately defiant of authority; difficult to manage

repudiate - to refuse to have anything to do with; disown

