abate - to lessen in intensity or degree

oscillation - the act or state of swinging back and forth with a steady, uninterrupted rhythm

opaque - impenetrable by light; not reflecting light; hard to understand

odious - evoking intense aversion or dislike

morose - sad; sullen; melancholy

inveigle - to obtain by deception or flattery

intransigent - refusing to compromise

innocuous - harmless, causing no damage

penurious - penny pinching; excessively thrifty; ungenerous

pernicious - extremely harmful; potentially causing death

peruse - to examine with great care

pious - extremely devout or reverent

precursor - one that precedes and indicates or announces another

preen - to dress up; to primp; to groom oneself with elaborate care

prodigious - abundant in size, force, or extent; extraordinary

prolific - producing large volumes or amounts; productive

putrefy - to rot; to decay and give off a foul odor

quaff - to drink deeply

quiescence - stillness; motionless; quality of being at rest

redoubtable - awe inspiring; worthy of honor

sanction - authoritative permission or approval; a penalty intended to enforce compliance; to give permission or authority to 

satire - a literary work that ridicules or criticizes a human vice through humor or derision

squalid - sordid; wretched and dirty as from neglect

stoic - indifferent to or unaffected by pleasure or pain; steadfast

supplant - to take place of; supercede

viscous - thick; sticky

vilify - to defame; to characterize harshly

torpid - lethargic or sluggish; dormant

ubiquitious - existing everywhere at the same time; constantly encountered; widespread

urbane - sophisticated; refined; elegant

furtive - marked by stealth; covert; surreptitious

elegy - a speech honoring the dead

exonerate - to remove blame

facetious - playful; humorous 

fallacy - an invalid or incorrect notion; a mistaken belief

esoteric - intended for or understood by a group that is small or specific

ephemeral - brief; fleeting

enigmatic - mysterious; obscure; difficult to understand

empirical - based on observation or experiment

emollient - soothing to the skin; making less harsh; mollifying ; an agent that softens or smooths skin

elegy - a mournful poem, esp one lamenting the dead

eclectic - composed of elements drawn from various sources

ebullience - the quality of lively or enthusiastic expression of thoughts and feelings

dogmatic - expressing a rigid opinino based on unproved or unprovable principles

disinterested - free of bias or self interest; impartial

discretion - cautious reserve in speech; ability to make responsible decisions

didactic - intended to teach or instruct 

demur - to question or oppose

dearth - smallness of quantity or number; scarcity; a lack

culpable - deserving blame

contrite - regretful; pentinent; seeking forgiveness

contentious - argumentative; quarrelsome; causing controversy or disagreement

complaisance - the willingness to comply with the wishes of others

cogent - appealing forcibly to the mind or reason; convincing

caustic - burning or stinging; causing corrosion

chary - wary; cautious; sparing 

catalyst - substance that accelerates the rate of a chemical reaction without itself changing; a person or thing that causes change

castigation - severe criticism or punishment 

canon - established set of rules, principles, or code of laws, often religious in nature

cacophony - rustic and pastoral charactersitic of rural areas and their inhabitants

burgeon - to grow or flourish 

axiom - a universally accepted principle 

avarice - greed, esp for wealth

ascetic - one who practices rigid self denial, esp as an act of religious devotion

ameliorate - to make better or more tolerable

aesthetic - dealing with, appreciative of, or responsive to art or the beautiful

adulation - excessive praise; intense adoration 

accolade - an expression of praise

abate - to lessen in intensity or degree

inert - unmoving, lethargic, sluggish 

incipient - beginning to come into being or to become apparent 

impecunious - lacking the funds, without money

hyperbole - an exaggerated statement; often used as a figure of speech

heretical - violating accepted dogmma or ritual 

harangue - to deliver a pompous speech or tirade

gregarious - sociable; outgoing; enjoying the company of other people